[OVERLAY]
┌──────────────────┐
│                  │
│いくつ\x75      コ    \x6b\x6b円│
│     ゛            │
│もってるかす    コ       │
└──────────────────┘